KEY ID	French
LocalButton	Local
OnlineButton	En ligne
HowToPlayButton	Comment jouer
FreePlayButton	Jeu libre
PublicHeader	Public
PrivateHeader	Privé
HostHeader	Héberger
ExitButton	Sortie
BackButton	Retour
AvailableGamesLabel	Parties disponibles
CreateGameButton	Créer une partie
FindGameButton	Trouver une partie
EnterCode	Entrer un code
GhostIgnoreTasks	Vous êtes mort. Profitez du chaos.
GhostDoTasks	Vous êtes mort. Finissez vos tâches pour gagner.
TotalTasksCompleted	Total des tâches accomplies
GhostImpostor	Vous êtes mort. Saboter est toujours possible.
ImpostorTask	Sabotez et tuez tout le monde.
FakeTasks	Tâches factices :
TaskComplete	Tâche terminée !
ExileTextSP	{0} était l'imposteur.
ExileTextSN	{0} n'était pas l'imposteur.
ExileTextPP	{0} était un imposteur.
ExileTextPN	{0} n'était pas un imposteur.
NoExileSkip	Personne n'a été éjecté. (Passe)
NoExileTie	Personne n'a été éjecté. (Égalité)
ExileTextNonConfirm	{0} a été éjecté(e).
ImpostorsRemainS	Il reste {0} imposteur.
ImpostorsRemainP	Il reste {0} imposteurs.
Hallway	Couloir
Engines	Moteurs
UpperEngine	Moteur supérieur
Cafeteria	Cafétéria
Weapons	Armes
Reactor	Réacteur
Security	Sécurité
MedBay	Infirmerie
LifeSupp	O2
Nav	Navigation
LowerEngine	Moteur inférieur
Electrical	Électricité
Admin	Admin
Storage	Cargo
Shields	Boucliers
Comms	Radio
Decontamination	Décontamination
Launchpad	Plateforme
LockerRoom	Vestiaires
Laboratory	Laboratoire
Balcony	Balcon
Office	Bureaux
Greenhouse	Jardins
DivertPowerTo	Dévier courant vers {0}
AcceptDivertedPower	Accepter courant dévié
SubmitScan	Envoyer scan
PrimeShields	Activer boucliers
FuelEngines	Faire le plein
ChartCourse	Tracer trajectoire
StartReactor	Démarrer réacteur
SwipeCard	Glisser carte
ClearAsteroids	Détruire astéroïdes
DownloadData	Télécharger données
UploadData	Transférer données
InspectSample	Examiner échantillon
EmptyChute	Vider vide-ordures
EmptyGarbage	Sortir poubelles
AlignEngineOutput	Aligner moteur
FixWiring	Réparer câblage
CalibrateDistributor	Calibrer distrib.
UnlockManifolds	Débloquer répartiteur
ResetReactor	Fusion du réacteur :
FixLights	Réparer lampes
CleanO2Filter	Nettoyer filtre O2
FixComms	Radio sabotée
RestoreOxy	Oxygène épuisé :
StabilizeSteering	Stabiliser contrôles
AssembleArtifact	Assembler artefact
SortSamples	Trier échantillons
MeasureWeather	Analyser météo
EnterIdCode	Entrer NIP
BuyBeverage	Acheter boisson
ProcessData	Traiter données
NumImpostorsS	Il y a <color=#FF1919FF>1 imposteur</color> parmi nous
NumImpostorsP	Il y a <color=#FF1919FF>{0} imposteurs</color> parmi nous
Crewmate	Coéquipier
Impostor	Imposteur
Victory	Victoire
Defeat	Défaite
CrewmatesDisconnected	Plupart des coéquipiers\ndéconnectés
ImpostorDisconnected	Imposteur déconnecté
PickAnomaly	Choisir anomalie
WaterPlantsGetCan	Arrosoir obtenu !
AuthOfficeOkay	Bureaux OK
AuthCommsOkay	Radio OK
AuthOfficeActive	Bureaux ACTIFS
AuthCommsActive	Radio ACTIVE
AuthOfficeNotActive	Bureaux NON ACTIFS
AuthCommsNotActive	Radio NON ACTIVE
SecLogEntry	{0} a franchi le capteur {1}
LogNorth	Nord
LogSouthEast	Sud-est
LogSouthWest	Sud-ouest
EnterName	Entrer nom
SwipeCardPleaseInsert	Insérez la carte
SwipeCardPleaseSwipe	Glissez la carte
SwipeCardBadRead	Illisible. Reessayez.
SwipeCardTooFast	Trop rapide. Reessayez.
SwipeCardTooSlow	Trop lent. Reessayez.
SwipeCardAccepted	Accepte. Merci.
ReactorHoldToStop	Maintenir pour stopper fusion
ReactorWaiting	En attente du 2e utilisateur
ReactorNominal	Réacteur minime
MeetingWhoIsTitle	Qui est l'imposteur ?
MeetingVotingBegins	Début des votes dans : {0} s
MeetingVotingEnds	Fin des votes dans : {0} s
MeetingVotingResults	Résultats des votes
MeetingProceeds	Procédure dans : {0} s
MeetingHasVoted	{0} a voté. {1} restant(s).
HowToPlayText1	Among Us est un jeu de trahison et de travail d'équipe.\n\nLes joueurs sont des coéquipiers ou des imposteurs.
HowToPlayText2	Disputez des parties de 4 à 15 joueurs en ligne ou en Wi-Fi local !
HowToPlayText41	Quand vous hébergez une partie, c'est vous qui fixez les règles.
HowToPlayText42	D'abord, choisissez avec qui vous voulez jouer !\n\nSi vous préférez jouer avec des amis en ligne, réglez sur « privé » et fournissez-leur le code de ce salon.\n\nSi vous voulez jouer avec des joueurs du monde entier, réglez sur « public ».
HowToPlayText43	Vous voulez plus de tâches ? Marcher plus vite ? Augmenter le nombre d'imposteurs ? En tant qu'hôte, vous pouvez modifier ces réglages. Pensez à avertir les autres joueurs.
HowToPlayText44	Si un joueur est grossier et/ou spamme non-stop, l'hôte peut l'expulser temporairement en guise d'avertissement ou le bannir du salon en ligne.
HowToPlayTextMap	Les joueurs ont accès à une carte pour les aider à parcourir le vaisseau.
HowToPlayTextCrew1	Objectif : remplir la barre des tâches ou découvrir l'imposteur.
HowToPlayTextCrew2	Remplissez la jauge en terminant des tâches.
HowToPlayTextCrew3	Réagissez à un sabotage de l'imposteur.
HowToPlayTextCrew4	Imposteur démasqué ? Demandez une réunion.
HowToPlayTextCrew5	Signalez des corps.
HowToPlayTextCrew6	Cherchez toute activité suspecte sur la carte Admin et Sécurité.
HowToPlayTextImp1	Objectif : tuer les membres d'équipage.
HowToPlayTextImp2	Devenez invisible parmi l'équipage.
HowToPlayTextImp3	Faufilez-vous dans les conduits d'aération.
HowToPlayTextImp4	Faites semblant d'accomplir des tâches.
HowToPlayTextImp5	Sabotez le vaisseau et embrouillez l'équipage.
HowToPlayTextImp6	Verrouillez les portes et enfermez des joueurs.
HowToPlayTextImp7	Tuez les membres d'équipage entre les temps morts.
HowToPlayText5	Lorsque vous jouez en personne, vous n'avez pas le droit de parler, histoire de garantir l'équité du jeu entre l'équipage et l'imposteur.\n\nSi l'imposteur tue un joueur, il est interdit à celui-ci de parler jusqu'à la fin de la partie.\n\nLes fantômes poursuivent toujours leurs tâches pour essayer de faire gagner leurs coéquipiers.
HowToPlayText6	Lorsqu'un joueur signale un corps ou demande une réunion d'urgence, les membres d'équipage se réunissent pour partager les infos qu'ils ont glanées sur l'imposteur.\n\nVous pourrez alors parler librement et présenter vos théories sur l'identité de l'imposteur. Si vous jouez en personne, les fantômes n'ont pas le droit de parler (vu qu'ils savent qui est l'imposteur).\n\nLes imposteurs essaieront de prouver leur innocence ou d'accuser un autre membre de l'équipage.
HowToPlayText7	Après discussion, votez pour le joueur qui, selon vous, est l'imposteur.\n\nLe joueur qui recueillera le plus de votes sera éjecté du vaisseau, alors votez judicieusement !\n\nVous pouvez aussi décider d'un commun accord de ne pas voter. Vous pourrez alors réunir plus d'informations et éviter ainsi d'éjecter un innocent.
HowToPlayText81	Entraînez-vous en mode Jeu libre !
HowToPlayText82	Configurez vos tâches comme membre d'équipage ou peaufinez vos stratégies meurtrières d'imposteur !
SettingsGeneral	Général
SettingsControls	Commandes
SettingsSound	Audio
SettingsGraphics	Graphismes
SettingsData	Données
SettingsCensorChat	Censurer chat
SettingsMusic	Musique
SettingsSFX	Effets sonores
SettingsOn	Oui
SettingsOff	Non
SettingsSendTelemetry	Envoyer télémétrie
SettingsControlMode	Mode Contrôle
SettingsTouchMode	Tactile
SettingsJoystickMode	Joystick
SettingsKeyboardMode	Souris+Clavier
SettingsFullscreen	Plein écran
SettingsVSync	Synchro verticale
SettingsResolution	Résolution
SettingsApply	Appliquer
SettingsPersonalizeAds	Personnaliser pubs
SettingsLanguage	Langue
SettingsJoystickSize	Taille
SettingsMouseMode	Souris
MatchMapName	Carte :
MatchLanguage	Chat :
MatchImpostors	Imposteurs :
MatchMaxPlayers	Joueurs max :
Cancel	Annuler
Confirm	Confirmer
PlayerColor	Couleur
PlayerHat	Tête
PlayerSkin	Skin
PlayerPet	Bestiole
GameSettings	Jeu
GameRecommendedSettings	Réglages recommandés
GameCustomSettings	Réglages personnalisés
GameMapName	Carte
GameNumImpostors	Nbre d'imposteurs
GameNumMeetings	Réunions d'urgence
GameDiscussTime	Temps de discussion
GameVotingTime	Temps de vote
GamePlayerSpeed	Vitesse joueurs
GameCrewLight	Vision coéquipiers
GameImpostorLight	Vision imposteurs
GameKillCooldown	Temps mort Frags
GameKillDistance	Distance frags
GameCommonTasks	Tâches communes
GameLongTasks	Tâches longues
GameShortTasks	Tâches courtes
GameEmergencyCooldown	Temps mort Urgence
GameSecondsAbbrev	{0}s
GameConfirmImpostor	Confirmer éjections
GameVisualTasks	Tâches visuelles
GameAnonymousVotes	Votes anonymes
GameTaskBarMode	MàJ barre des tâches
SettingNormalTaskMode	Toujours
SettingMeetingTaskMode	Réunions
SettingInvisibleTaskMode	Jamais
Limit	Limite
RoomCode	Code
LeaveGame	Quitter partie
ReturnToGame	Retour au jeu
LocalHelp	Des soucis de connexion ?\n\n● Vérifiez que tout le monde est connecté au\nmême réseau Wi-Fi\n● Vérifiez que tout le monde possède la même version (voir en haut à gauche)\n● Vérifiez que le signal Wi-Fi est suffisamment fort\n● Essayez de confier l'hébergement de la partie à un autre joueur\n● Essayez de redémarrer l'application\n● Essayez de redémarrer votre téléphone\n● Le problème persiste ? Contactez-nous sur notre Discord !
OnlineHelp	Comment ça marche ?\n\n● Héberger une partie génère un code qui s'affiche à côté du bouton de démarrage.\n● Fournissez ce code à vos amis pour créer un salon privé.\n● Ou sélectionnez Privé afin de rendre le salon public\npour l'option « Trouver partie ».\n● L'hôte peut bannir ou expulser des joueurs chaque fois que le chat est disponible.\n● Le problème persiste ? Contactez-nous sur notre Discord !
EmergencyCount	LE COÉQUIPIER {0} A\n\n\n\nRÉUNION(S) D'URGENCE RESTANTE(S)
EmergencyNotReady	LES COÉQUIPIERS DOIVENT ATTENDRE\n\n\n\nAVANT LA PROCHAINE URGENCE
EmergencyDuringCrisis	IMPOSSIBLE DE TENIR DES RÉUNIONS\nD'URGENCE PENDANT UNE CRISE
EmergencyRequested	RÉUNION D'URGENCE DEMANDÉE\nEN ATTENTE DE L'HÔTE
AdPolicyTitle	Politique publicitaire
AdPolicyText	Pouvons-nous utiliser vos données personnelles pour vous proposer des publicités personnalisées ? Si vous cliquez sur "oui", nos partenaires publicitaires, tels que Google AdMob et Unity Ads, collecteront automatiquement des données et utiliseront des identifiants d'appareils, ainsi que des cookies pour la personnalisation des publicités. Si vous cliquez sur "non", il est possible que vous receviez toujours des publicités non personnalisées. Pour supprimer toutes les publicités, achetez la mise à niveau sans pub [httpstore]ici[]. Vous et vos amis ne recevrez alors plus aucune publicité lorsque vous hébergerez des parties ! Pour en savoir plus sur nos pratiques de confidentialité et celles de nos partenaires publicitaires, veuillez consulter notre [https://innersloth.com/privacy.php]Charte de confidentialité[]. Vous pouvez modifier votre décision à tout moment dans le menu des paramètres, sous "Données".
Accept	Accepter
RemoveAds	Supprimer pubs
PlainYes	Oui
PlainNo	Non
PrivacyPolicyTitle	Charte de confidentialité
PrivacyPolicyText	Innersloth traite les données personnelles pour Among Us. Veuillez lire notre <link="https://innersloth.com/privacy.php">Charte de confidentialité</link> pour obtenir de plus amples renseignements sur nos pratiques relatives à la vie privée. Vous pouvez gérer vos paramètres de données personnelles pour Among Us via l'option « Données ».
ManageDataButton	Gérer la collecte des données
UnderstandButton	Je comprends
WaterPlants	Arroser plantes
WeatherEta	ETA : {0}s
WeatherComplete	Terminé
RunDiagnostics	Lancer diagnostiques
SettingShort	Court
SettingMedium	Moyen
SettingLong	Long
SamplesPress	Appuyer pour commencer
SamplesAdding	Ajouter réactifs
SamplesSelect	Sélectionner anomalie
SamplesThanks	Merci !
SamplesComplete	Test effectué
AstDestroyed	Détruits : {0}
TaskTestTitle	Tâches-Testeur 2000
BeginDiagnostics	Demarrer diagnostics
UserLeftGame	{0} a quitté la partie.
GameStarting	Démarrage dans {0}
ChatRateLimit	Trop rapide. Attendez {0} secondes
Tasks	Tâches
MedscanRequested	Scan demandé
MedscanWaitingFor	En attente de {0}
MedscanCompleted	Scan effectué !
MedscanCompleteIn	Scan terminé dans {0}
StatsTitle	Statistiques
StatsBodiesReported	Corps signalés :\t
StatsEmergenciesCalled	Urgences appelées :\t
StatsTasksCompleted	Tâches terminées :\t
StatsAllTasksCompleted	Toutes les tâches terminées :\t
StatsSabotagesFixed	Sabotages réparés :\t
StatsImpostorKills	Frags d'imposteur :\t\t
StatsTimesMurdered	Nbre de fois tué(e) :\t
StatsTimesEjected	Nbre de fois éjecté(e) :\t\t
StatsCrewmateStreak	Parties consécutives dans l'équipage :\t
StatsGamesImpostor	Nbre de fois imposteur :\t
StatsGamesCrewmate	Nbre de fois coéquipier :\t
StatsGamesStarted	Parties commencées :\t
StatsGamesFinished	Parties terminées :\t
StatsImpostorVoteWins	Victoires par votes (imposteur) :\t
StatsImpostorKillsWins	Victoires par frags (imposteur) :\t
StatsImpostorSabotageWins	Victoires par sabotage (imposteur) :\t
StatsCrewmateVoteWins	Victoires par votes (coéquipier) :\t
StatsCrewmateTaskWins	Victoires par tâches (coéquipier) :\t
MonitorOxygen	Examiner arbre
StoreArtifacts	Ranger artefacts
FillCanisters	Remplir bombonnes
InsertKeys	Insérer clés
ResetSeismic	RàZ stabiliseurs sismiques
SeismicHoldToStop	Maintenir pour activer stabiliseurs sismiques
SeismicNominal	Activité sismique minime
ScanBoardingPass	Scanner carte passager
FixWeatherNode	Réparer nœud météo
OpenWaterways	Ouvrir tuyaux
ReplaceWaterJug	Remplacer bombonne d'eau
RepairDrill	Réparer foreuse
AlignTelescope	Aligner télescope
RecordTemperature	Consigner température
RebootWifi	Relancer Wi-Fi
WifiRebootRequired	Redémarrage requis
WifiPleaseWait	Veuillez patienter
WifiPleaseReturnIn	Veuillez revenir dans {0} s
WifiPleasePowerOn	Veuillez allumer
WifiRebootComplete	Redémarrage terminé
Outside	Extérieur
Dropship	Navette
Decontamination2	Décontamination
Specimens	Salle Spécimens
BoilerRoom	Chaufferie
GameOverImpostorDead	Normalement, l'imposteur étant mort, l'équipage gagnerait... mais en Jeu libre, tout le monde ressuscite.
GameOverImpostorKills	Normalement, l'équipage ne pouvant plus gagner, l'imposteur remporterait la victoire... mais en Jeu libre, tout le monde ressuscite.
GameOverTaskWin	Normalement, la barre de tâche étant remplie, l'équipage gagnerait... mais en Jeu libre, de nouvelles tâches sont générées.
GameOverSabotage	Normalement, l'imposteur ayant réussi un sabotage critique, il gagnerait. Mais au lieu de ça, on arrête tout.
HowToPlayText2Switch	Disputez des parties de 4 à 15 joueurs en ligne\n\navec votre abonnement Nintendo Switch Online ou via le Wi-Fi local !
VentDirection	Sens Conduits aération
VentMove	Utilisez les conduits
MenuNavigate	Parcourir
NsoError	Impossible de se connecter au réseau.
ErrorServerOverload	Les serveurs d'Among Us sont surchargés.\r\n\r\nDésolé ! Veuillez réessayer plus tard !
ErrorIntentionalLeaving	Après une déconnexion intentionnelle, vous devez attendre {0} minutes de plus avant de pouvoir rejoindre une autre partie.
ErrorFocusLost	Vous avez été déconnecté parce qu'Among Us a été suspendu par une autre application.
ErrorBanned	Vous avez été expulsé de {0}.\r\n\r\nVous ne pouvez pas rejoindre ce salon.
ErrorKicked	Vous avez été expulsé de {0}.\r\n\r\nVous pouvez rejoindre les hostilités si le salon n'a pas démarré.
ErrorBannedNoCode	Vous avez été banni du salon.\r\n\r\nVous ne pouvez pas rejoindre ce salon.
ErrorKickedNoCode	Vous avez été expulsé du salon.\r\n\r\nVous pouvez rejoindre les hostilités si le salon n'a pas démarré.
ErrorHacking	Vous avez été banni pour piratage.\r\n\r\nVeuillez arrêter.
ErrorFullGame	La partie que vous essayez d'intégrer est saturée.\r\n\r\nDemandez à l'hôte si vous pouvez rejoindre la partie lors de la prochaine manche.
ErrorStartedGame	La partie que vous essayez d'intégrer a déjà commencé.\r\n\r\nDemandez à l'hôte si vous pouvez rejoindre la partie lors de la prochaine manche.
ErrorNotFoundGame	Impossible de localiser la partie que vous recherchez.
ErrorInactivity	Le serveur a mis fin à cette partie, peut-être en raison d'inactivité.
ErrorGenericOnlineDisconnect	Vous avez été déconnecté du serveur.\r\nSi cela se produit souvent, consultez la force de votre réseau.\r\nIl peut également s'agir d'un problème de serveur.
ErrorGenericLocalDisconnect	Vous avez été déconnecté du serveur.\r\n\r\nSi cela se produit souvent, consultez la force de votre Wi-Fi.
ErrorInvalidName	Nom d'utilisateur refusé par le serveur : {0}
ErrorUnknown	Une erreur inconnue vous a déconnecté du serveur.
ErrorIncorrectVersion	Vous exécutez une version obsolète du jeu.\r\n\r\nVeuillez effectuer la mise à jour pour jouer avec d'autres joueurs.
	
ServerNA	Amérique du Nord
ServerEU	Europe
ServerAS	Asie
ServerSA	Amérique du Sud
LangEnglish	English
LangFrench	Français
LangItalian	Italiano
LangGerman	Deutsch
LangSpanish	Español
LangSpanishLATAM	Español (Latinoamérica)
LangBrazPort	Português (Brasil)
LangPort	Português
LangRussian	Русский
LangJapanese	日本語
LangKorean	한국어
LangDutch	Nederlands
LangFilipino	Bisaya
PlayerName	Joueur
MyTablet	Ma tablette
Headquarters	QG
DownloadTestEstTimeS	Temps estimé : {0}s
DownloadTestEstTimeMS	Temps estimé : {0}m {1}s
DownloadTestEstTimeHMS	Temps estimé : {0}hr {1}m {2}s
DownloadTestEstTimeDHMS	Temps estimé : {0}d {1}hr {2}m {3}s
DownloadComplete	Terminé
GrabCoffee	ALLEZ VOUS FAIRE UN CAFÉ
TakeBreak	FAITES UNE PAUSE
DontNeedWait	VOUS POUVEZ NE PAS ATTENDRE
DoSomethingElse	ALLEZ FAIRE UN TOUR
NodeTB	Nœud_TB
NodeIRO	Nœud_IRO
NodeGI	Nœud_GI
NodePD	Nœud_PD
NodeCA	Nœud_CA
NodeMLG	Nœud_MLG
Vending	EN COURS
OtherLanguage	Autre
ImposterAmtAny	1-3
	
VitalsORGN	ORGN
VitalsBLUE	BLEU
VitalsRED	ROUGE
VitalsBRWN	MARN
VitalsGRN	VRT
VitalsPINK	ROSE
VitalsWHTE	BLNC
VitalsYLOW	JNE
VitalsBLAK	NOIR
VitalsPURP	VIO
VitalsCYAN	CYAN
VitalsLIME	CIT
ColorOrange	ORANGE
ColorBlue	BLEU
ColorRed	ROUGE
ColorBrown	MARRON
ColorGreen	VERT
ColorPink	ROSE
ColorWhite	BLANC
ColorYellow	JAUNE
ColorBlack	NOIR
ColorPurple	VIOLET
ColorCyan	CYAN
ColorLime	CITRON
ColorMaroon	BORDEAUX
ColorRose	CHAIR
ColorBanana	BANANE
ColorGray	GRIS
ColorTan	BRONZÉ
ColorCoral	CORAIL
MedID	ID :
MedC	C :
MedHT	T :
MedBT	GS :
MedWT	P :
MedETA	ETA : {0}
MedHello	BONJOUR !
LobbySizeWarning	Among Us est jouable à 4 joueurs, mais il est recommandé d'y jouer à 5 joueurs ou plus.\n\nLes parties à 4 joueurs finissent vite et généralement, l'imposteur gagne.
Okay	OK
OkayDontShow	OK, ne plus afficher
Nevermind	Peu importe
CamEast	Est
CamCentral	Central
CamNortheast	Nord-Est
CamSouth	Sud
CamSouthwest	Sud-Ouest
CamNorthwest	Nord-Ouest
LoadingFailed	Échec du chargement :
PetFailFetchData	Données de la bestiole irrécupérables
BadResult	ERREUR
More	{0} DE PLUS
Processing	En traitement
ExitGame	Quitter la partie
WaitingForHost	En attente de l'hôte
LeftGameError	{0} a quitté la partie à cause d'une erreur.
PlayerWasBannedBy	{0} a été banni par {1}
PlayerWasKickedBy	{0} a été expulsé par {1}
Dummy	Mannequin
Bad	MAUVAIS
Status	Statut : 
Fine	BON
OK	OK
SecondsAbbv	{0}s
PetTryOn	Essayez quelque chose !
DataPolicyWhat	Que collecte-t-on ?
	
	
	
VaultRoom	Chambre forte
Cockpit	Cockpit
Armory	Armurerie
Kitchen	Cuisine
ViewingDeck	Poste d'obs.
HallOfPortraits	Salle des portraits
Medical	Médical
CargoBay	Soute
Ventilation	Ventilation
Showers	Douches
Engine	Moteurs
Brig	Cellules
MeetingRoom	Salle de réunion
Records	Archives
Lounge	Salon
GapRoom	Plateforme
MainHall	Couloir central
	
PolishRuby	Polir rubis
ResetBreakers	Réinitialiser disjoncteurs
Decontaminate	Désinfecter
MakeBurger	Préparer burger
UnlockSafe	Déverr. coffre
SortRecords	Classer dossiers
PutAwayPistols	Ranger pistolets
PutAwayRifles	Ranger fusils
FixShower	Réparer douche
CleanToilet	Déboucher toilettes
DressMannequin	Habiller mannequin
PickUpTowels	Ramasser serviettes
RewindTapes	Rembobiner cassettes
StartFans	Démarrer ventilation
DevelopPhotos	Développer photos
GetBiggolSword	Obtenir l'épée Biggol
StopCharles	Éviter la collision
	
RevealCode	Révéler code
DirtyHeader	SALE
AuthLeftOkay	Côté gauche OK
AuthRightOkay	Côté droit OK
AuthLeftActive	Côté gauche ACTIF
AuthRightActive	Côté droit ACTIF
AuthLeftNotActive	Côté gauche NON ACTIF
AuthRightNotActive	Côté droit NON ACTIF
EngagementScreen	Appuyer sur un bouton.
DeleteButton	Supprimer
QuickChat	Chat rapide
QCLocationLaptop	Portable
QCLocationSkeld	Skeld
QCLocationMira	Mira 
QCLocationPolus	Polus
QCSystemsStart	Démarrer
QCSystemsKick	Expulser
QCCrewI	Je
QCCrewMe	Moi
QCCrewNoOne	Personne
QCAccAKilledB	{0} a tué {1}
QCAccAKilledBNeg	{0} n'a pas tué {1}
QCAccAIsSuspicious	{0} est suspect(e)
QCAccAIsSuspiciousNeg	{0} est clean
QCAccASawBVent	{0} a vu {1} dans un conduit
QCAccASawBVentNeg	{0} n'a jamais vu {1} dans un conduit
QCAccAWasChasingB	{0} poursuivait {1}
QCAccAWasChasingBNeg	{0} ne poursuivait pas {1}
QCAccAIsLying	{0} ment
QCAccAIsLyingNeg	{0} dit la vérité
QCAccVoteA	Votez contre {0}
QCAccVoteANeg	Ne votez pas contre {0}
QCAccADidntReport	{0} n'a pas signalé\n le corps
QCResYes	Oui
QCResNo	Non
QCResDontKnow	Je ne sais pas
QCResDontKnowNeg	Peut-être
QCResAWas	C'était {0}
QCResAWasNeg	Ce n'était pas {0}
QCResADid	{0} l'a fait
QCResADidNeg	{0} ne l'a pas fait
QCResVote	Votez
QCResVoteNeg	Passez vote
QCResAWasAtB	{0} était ici : {1}
QCResAWasAtBNeg	{0} n'était pas ici : {1}
QCResRip	RIP
QCResRipNeg	Alleeez !
QCResLies	Mensonges
QCResLiesNeg	OK
QCQstWhere	Où ?
QCQstWho	Qui ?
QCQstWhoWasWith	Qui était avec {0} ?
QCQstWhatWasADoing	Qu'est-ce que {0} faisait ?
QCQstWhoFixedA	Qui a réparé : {0} ?
QCQstWhereWasA	Où était {0} ?
QCQstBodyOrMeeting	Était-ce un corps ou une réunion d'urgence ?
QCStaASawB	{0} a vu {1}
QCStaAWasWithB	{0} était avec {1}
QCStaADidB	{0} a fait : {1}
QCStaASelfReported	{0} a auto-signalé
QCStaDoubleKill	C'était un double\n meurtre
QCStaWasSelfReport	C'était un auto-signalement
QCStaPleaseDoTasks	Accomplissez vos tâches
QCStaBodyWasInA	Le corps était ici : {0}
QCStaACalledMeeting	{0} a demandé une réunion
QCLocation	Lieu
QCSystems	Systèmes
QCCrew	Équipage
QCAccusation	Accusation
QCResponse	Réponse
QCQuestion	Question
QCStatements	Déclarations
ChatType	Type de chat
QuickChatOnly	Chat rapide uniquement
FreeChatOnly	Chat libre uniquement
FreeOrQuickChat	Chat libre ou rapide
DateOfBirth	Date de naissance
DateOfBirthEnter	Veuillez saisir votre date de naissance :
Month	Mois :
Day	Jour :
Year	Année :
January	Janvier
February	Février
March	Mars
April	Avril
May	Mai
June	Juin
July	Juillet
August	Août
September	Septembre
October	Octobre
November	Novembre
December	Décembre
Submit	Soumettre
	
QCAccAKilledB_QCCrewMe_ANY	J'ai tué {1}
QCAccAKilledB_QCCrewMe_QCCrewNoOne	Je n'ai tué personne
QCAccAKilledB_QCCrewMe_QCCrewMe	
QCAccAKilledB_ANY_QCCrewMe	{0} m'a tué
QCAccAKilledB	{0} a tué {1}
QCAccAKilledB_ANY_QCCrewNoOne	{0} n'a tué personne
QCAccAKilledB_QCCrewNoOne_QCCrewMe	Personne ne m'a tué
QCAccAKilledB_QCCrewNoOne_ANY	Personne n'a tué {1}
QCAccAKilledB_QCCrewNoOne_QCCrewNoOne	Personne n'a tué quiconque
QCAccAKilledBNeg_QCCrewMe_ANY	Je n'ai pas tué {1}
QCAccAKilledBNeg_QCCrewMe_QCCrewNoOne	Je n'ai tué personne
QCAccAKilledBNeg_QCCrewMe_QCCrewMe	Je ne me suis pas tué
QCAccAKilledBNeg_ANY_QCCrewMe	{0} ne m'a pas tué
QCAccAKilledBNeg	{0} n'a pas tué {1}
QCAccAKilledBNeg_ANY_QCCrewNoOne	{0} n'a tué personne
QCAccAKilledBNeg_QCCrewNoOne_QCCrewMe	
QCAccAKilledBNeg_QCCrewNoOne_ANY	
QCAccAKilledBNeg_QCCrewNoOne_QCCrewNoOne	
QCAccAIsSuspicious_QCCrewMe	Je suis suspect
QCAccAIsSuspicious	{0} est suspect
QCAccAIsSuspicious_QCCrewNoOne	Personne n'est suspect
QCAccAIsSuspiciousNeg_QCCrewMe	Je suis clean
QCAccAIsSuspiciousNeg	{0} est clean
QCAccAIsSuspiciousNeg_QCCrewNoOne	Personne n'est clean
QCAccASawBVent_QCCrewMe_ANY	J'ai vu {1} dans un conduit
QCAccASawBVent_QCCrewMe_QCCrewNoOne	Je n'ai vu personne dans un conduit
QCAccASawBVent_QCCrewMe_QCCrewMe	
QCAccASawBVent_ANY_QCCrewMe	{0} m'a vu dans un conduit
QCAccASawBVent	{0} a vu {1} dans un conduit
QCAccASawBVent_ANY_QCCrewNoOne	{0} n'a vu personne dans un conduit
QCAccASawBVent_QCCrewNoOne_QCCrewMe	Personne ne m'a vu dans un conduit
QCAccASawBVent_QCCrewNoOne_ANY	Personne n'a vu {1} dans un conduit
QCAccASawBVent_QCCrewNoOne_QCCrewNoOne	Personne n'a vu quiconque dans un conduit
QCAccASawBVentNeg_QCCrewMe_ANY	Je n'ai jamais vu {1} dans un conduit
QCAccASawBVentNeg_QCCrewMe_QCCrewNoOne	Je n'ai jamais vu quiconque dans un conduit
QCAccASawBVentNeg_QCCrewMe_QCCrewMe	
QCAccASawBVentNeg_ANY_QCCrewMe	{0} ne m'a jamais vu dans un conduit
QCAccASawBVentNeg	{0} n'a jamais vu {1} dans un conduit
QCAccASawBVentNeg_ANY_QCCrewNoOne	{0} n'a jamais vu quiconque dans un conduit
QCAccASawBVentNeg_QCCrewNoOne_QCCrewMe	Personne ne m'a jamais vu dans un conduit
QCAccASawBVentNeg_QCCrewNoOne_ANY	Personne n'a jamais vu {1} dans un conduit
QCAccASawBVentNeg_QCCrewNoOne_QCCrewNoOne	Personne n'a jamais vu quiconque dans un conduit
QCAccAWasChasingB_QCCrewMe_ANY	Je poursuivais {1}
QCAccAWasChasingB_QCCrewMe_QCCrewNoOne	Je ne poursuivais personne
QCAccAWasChasingB_QCCrewMe_QCCrewMe	
QCAccAWasChasingB_ANY_QCCrewMe	{0} me poursuivait
QCAccAWasChasingB	{0} poursuivait {1}
QCAccAWasChasingB_ANY_QCCrewNoOne	{0} ne poursuivait personne
QCAccAWasChasingB_QCCrewNoOne_QCCrewMe	Personne ne me poursuivait
QCAccAWasChasingB_QCCrewNoOne_ANY	Personne ne poursuivait {1}
QCAccAWasChasingB_QCCrewNoOne_QCCrewNoOne	Personne ne poursuivait quiconque
QCAccAWasChasingBNeg_QCCrewMe_ANY	Je ne poursuivais pas {1}
QCAccAWasChasingBNeg_QCCrewMe_QCCrewNoOne	Je ne poursuivais personne
QCAccAWasChasingBNeg_QCCrewMe_QCCrewMe	
QCAccAWasChasingBNeg_ANY_QCCrewMe	{0} ne me poursuivait pas
QCAccAWasChasingBNeg	{0} ne poursuivait pas {1}
QCAccAWasChasingBNeg_ANY_QCCrewNoOne	{0} ne poursuivait personne
QCAccAWasChasingBNeg_QCCrewNoOne_QCCrewMe	
QCAccAWasChasingBNeg_QCCrewNoOne_ANY	
QCAccAWasChasingBNeg_QCCrewNoOne_QCCrewNoOne	
QCAccAIsLying_QCCrewMe	Je mens
QCAccAIsLying	{0} ment
QCAccAIsLying_QCCrewNoOne	Personne ne ment
QCAccAIsLyingNeg_QCCrewMe	Je dis la vérité
QCAccAIsLyingNeg	{0} dit la vérité
QCAccAIsLyingNeg_QCCrewNoOne	Tout le monde ment
QCAccVoteA_QCCrewMe	Votez contre moi
QCAccVoteA	Votez contre {0}
QCAccVoteA_QCCrewNoOne	Ne votez pas
QCAccVoteANeg_QCCrewMe	Ne votez pas contre moi
QCAccVoteANeg	Ne votez pas contre {0}
QCAccVoteANeg_QCCrewNoOne	
QCAccADidntReport_QCCrewMe	Je n'ai pas signalé le corps
QCAccADidntReport	{0} n'a pas signalé le corps
QCAccADidntReport_QCCrewNoOne	
QCResAWas_QCCrewMe	C'était moi
QCResAWas	C'était {0}
QCResAWas_QCCrewNoOne	Ce n'était personne
QCResAWasNeg_QCCrewMe	Ce n'était pas moi
QCResAWasNeg	Ce n'était pas {0}
QCResAWasNeg_QCCrewNoOne	
QCResADid_QCCrewMe	Je l'ai fait
QCResADid	{0} l'a fait
QCResADid_QCCrewNoOne	Personne ne l'a fait
QCResADidNeg_QCCrewMe	Je ne l'ai pas fait
QCResADidNeg	{0} ne l'a pas fait
QCResADidNeg_QCCrewNoOne	
QCResAWasAtB_QCCrewMe_ANY	J'étais ici : {1}
QCResAWasAtB	{0} était ici : {1}
QCResAWasAtB_QCCrewNoOne_ANY	Personne n'était ici : {1}
QCResAWasAtBNeg_QCCrewMe_ANY	Je n'étais pas ici : {1}
QCResAWasAtBNeg	{0} n'était pas ici : {1}
QCResAWasAtBNeg_QCCrewNoOne_ANY	
QCQstWhoWasWith_QCCrewMe	Qui était avec moi ?
QCQstWhoWasWith	Qui était avec {0} ?
QCQstWhoWasWith_QCCrewNoOne	Qui était tout(e) seul(e) ?
QCQstWhatWasADoing_QCCrewMe	
QCQstWhatWasADoing	Que faisait {0} ?
QCQstWhatWasADoing_QCCrewNoOne	
QCQstWhereWasA_QCCrewMe	
QCQstWhereWasA	Où était {0} ?
QCQstWhereWasA_QCCrewNoOne	
QCStaASawB_QCCrewMe_ANY	J'ai vu {1}
QCStaASawB_QCCrewMe_QCCrewNoOne	Je n'ai vu personne
QCStaASawB_QCCrewMe_QCCrewMe	
QCStaASawB_ANY_QCCrewMe	{0} m'a vu
QCStaASawB	{0} a vu {1}
QCStaASawB_ANY_QCCrewNoOne	{0} n'a vu personne
QCStaASawB_QCCrewNoOne_QCCrewMe	Personne ne m'a vu
QCStaASawB_QCCrewNoOne_ANY	Personne n'a vu {1}
QCStaASawB_QCCrewNoOne_QCCrewNoOne	Personne n'a vu quiconque
QCStaAWasWithB_QCCrewMe_ANY	J'étais avec {1}
QCStaAWasWithB_QCCrewMe_QCCrewNoOne	J'étais tout(e) seul(e)
QCStaAWasWithB_QCCrewMe_QCCrewMe	
QCStaAWasWithB_ANY_QCCrewMe	{0} était avec moi
QCStaAWasWithB	{0} était avec {1}
QCStaAWasWithB_ANY_QCCrewNoOne	{0} était tout(e) seul(e)
QCStaAWasWithB_QCCrewNoOne_QCCrewMe	Personne n'était avec moi
QCStaAWasWithB_QCCrewNoOne_ANY	Personne n'était avec {1}
QCStaAWasWithB_QCCrewNoOne_QCCrewNoOne	Personne n'était avec quiconque
QCStaADidB_QCCrewMe_ANY	J'ai fait : {1}
QCStaADidB	{0} a fait : {1}
QCStaADidB_QCCrewNoOne_ANY	Personne n'a fait : {1}
QCStaASelfReported_QCCrewMe	Je me suis auto-signalé(e)
QCStaASelfReported	{0} s'est auto-signalé(e)
QCStaASelfReported_QCCrewNoOne	Personne ne s'est auto-signalé
QCStaACalledMeeting_QCCrewMe	J'ai demandé une réunion
QCStaACalledMeeting	{0} a demandé une réunion
QCStaACalledMeeting_QCCrewNoOne	Personne n'a demandé une réunion
QCMore	PLUS
SecurityLogsSystem	Journaux de sécurité
SecurityCamsSystem	Caméra de sécurité
AdminMapSystem	Carte d'Admin
VitalsSystem	Moniteur signes vitaux
EngagementScreenSignIn	Connexion...
SaveGameOutOfSpaceConfirm	Continuer
EngagementScreen	Appuyer sur un bouton.
SaveGameOutOfSpaceMessage	Voulez-vous continuer sans sauvegarder ?
SaveGameOutOfSpaceConfirm	Continuer
SaveGameOutOfSpaceCancel	Réessayer
Success	Succès !
Failed	Échec !
ErrorCreate	Une erreur s'est produite pendant la création de votre compte. Veuillez réessayer plus tard.
SuccessCreate	Vous avez créé un compte avec succès !
Close	Fermer
ErrorLogIn	Une erreur s'est produite pendant la connexion à votre compte. Veuillez réessayer plus tard.
SuccessLogIn	Vous vous êtes connecté(e) à votre compte avec succès !
AccountInfo	INFOS DU COMPTE
Account	COMPTE
UserName	NOM D'UTILISATEUR
Height	Taille
Weight	Poids
SignIn	Connexion
CreateAccount	Créer compte
RequestPermission	Demander autorisation
RandomizeName	Randomiser nom
AccountLinking	Jumelage du compte
ChangeName	Changer de nom
LogOut	Déconnexion
GuardianWait	Vous devez attendre que votre tuteur vous donne l'autorisation d'utiliser le Chat libre et de changer votre nom d'utilisateur.
EmailEdit	Modifier adresse
EmailResend	Renvoyer e-mail
GuestContinue	Continuer (invité)
GuardianEmailSent	E-mail envoyé au tuteur
GuardianCheckEmail	N'oubliez pas de demander à votre tuteur de consulter l'e-mail pour débloquer toutes les fonctionnalités du jeu.
EditName	Modifier nom
Name	Nom
CreateAccountQuestion	Créer compte ?
DoYouWantCreate	Voulez-vous créer un compte ?
PermissionRequired	Autorisation requise
NeedPermissionText	Nous devons demander à votre tuteur (par e-mail) l'autorisation de continuer. S'il répond oui, vous pourrez utiliser le Chat libre en ligne et changer votre nom d'utilisateur. Demandez à un adulte de vous aider !
GuardianEmailTitle	Adresse e-mail du tuteur
Send	Envoyer
NewEmail	Nouvelle adresse e-mail
ConfirmEmail	Confirmer adresse e-mail
EditEmail	Modifier adresse e-mail
Loading	Chargement
Welcome	BIENVENUE
GuardianEmail	[adresse e-mail de votre tuteur]
	
BanButton	BANNIR
KickButton	EXPULSER
ReportButton	SIGNALER
ReportConfirmation	Vous avez signalé l'utilisateur suivant avec succès.
ReportBadName	Nom inapproprié
ReportBadChat	Chat inapproprié
ReportHacking	Piratage/Tricherie
ReportHarassment	Harcèlement/Conduite abusive
ReportWhy	Pourquoi signalez-vous cet utilisateur ?
DLLNotFoundAccountError	Votre accès aux services en ligne semble rencontrer un petit souci. Tant que ce problème n'est pas réglé, vous ne pouvez jouer qu'en modes Local ou Jeu libre. Veuillez réessayer plus tard.
ContinueOffline	Jouer hors ligne
WantToLogIn	Vous n'êtes actuellement pas connecté à un compte.
GoOffline	Jouer hors ligne
PlayAsGuest	Jouer en tant qu'invité
LogInTitle	Connectez-vous à votre compte
LogInInfoText	- Un compte invité vous permet de jouer en ligne sans lier de compte, mais attention, un compte invité ne peut pas être récupéré si vous changez d'appareil ou désinstallez Among Us.\n- Si vous vous connectez à un compte complet, vous pourrez toujours vous reconnecter plus tard. Si vous n'avez pas de compte, un compte sera créé pour vous automatiquement.
LogInInfoTextSwitch	Si vous vous connectez à un compte complet, vous pourrez toujours vous reconnecter plus tard. Si vous n'avez pas de compte, un compte sera créé pour vous automatiquement.
ControllerDisconnectedMessage	Manette déconnectée
FollowUs	Suivez-nous !
	
QuickChatInstructionsStart	Vos paramètres sont réglés sur « Chat rapide uniquement ».
QuickChatInstructionsChild	Vous devez obtenir l'accord de vos parents pour accéder au chat complet.
QuickChatInstructionsGuest	Vous devez être connecté pour modifier cette option.
QuickChatInstructionsFull	Vous pouvez modifier cette option depuis le menu Réglages.
	
SwitchEShopBrowseAll	Parcourir tous les articles sur Nintendo eShop
	
Download	Télécharger
Upload	Transférer
pk05_davehat	Casquette de Dave
pk05_Ellie	Ellie
pk05_Svenhat	Chapeau de Sven
pk05_Burthat	Chapeau de Burt
pk05_Ellryhat	Mohawk d'Ellry
pk05_monocles	Double monocle
pk05_cheesetoppat	Haut-de-forme fromage
pk05_Macbethhat	Haut-de-forme de M. Macbeth
pk05_HenryToppat	Haut-de-forme d'Henry
pk05_EllieToppat	Haut-de-forme d'Ellie
pk05_GeoffreyToppat	Haut-de-forme de Geoffrey
	
	
InsufficientStorageError	L'espace de stockage était insuffisant pour télécharger le pack d'éléments. Veuillez libérer de l'espace sur votre appareil et réessayer.
NetworkError	Une erreur de réseau s'est produite. Veuillez vérifier vos paramètres de connexion et réessayer.
OtherDownloadError	Une erreur s'est produite : {0}
DownloadingLabel	Téléchargement {0}
DownloadSizeLabel	Taille du téléchargement : {0} Mo
	
TimeRemaining	Durée restante : {0}
DeadLabel	MORT(S)
	
InviteFriends	Inviter des amis
	
NutriLabel	NUTRI
CO2Label	CO2
RADLabel	RAD
WaterLabel	EAU
	
DoorlogLabel	PORTES
VitalsLabel	SIGNES VITAUX
OptionsLabel	PERSONNALISER
ProceedLabel	CONTINUER
StartLabel	DÉMARRER
UseLabel	UTILISER
PlayAgain	REJOUER
QuitLabel	QUITTER
ReportLabel	SIGNALER
SabotageLabel	SABOTAGE
VentLabel	CONDUIT
KillLabel	TUER
DiscussLabel	DISCUTEZ !
SkippedVoting	VOTE PASSÉ
SkipVoteLabel	PASSER VOTE
EmergencyMeeting	RÉUNION D'URGENCE
BodyReported	CADAVRE SIGNALÉ
SkinLabel	SKINS
HatLabel	CHAPEAUX
PetLabel	BESTIOLES
AnnouncementLabel	ANNONCES
	
UploadingLabel	TRANSFERT
ConnectionLabel	Connexion :
NoneLabel	AUCUNE
PoorLabel	FAIBLE
GoodLabel	BONNE
LogLabel	REGISTRE
ReadingLabel	CAPTEUR
WeatherDataDownload	TÉLÉCHARGEMENT DONNÉES MÉTÉO
AirshipBundle	Pack Airship
PolusBundle	Pack Polus
PolusSkinBundle	Pack de skins Polus
MiraBundle	Pack MIRA HQ
MiraSkinBundle	Pack de skins MIRA HQ
PetAlien2	Pack de bestioles Krabouille
PetAlien1	Pack de bestioles Poulpe
PetAnimal	Pack de bestioles Hamster
PetCrewmate	Pack Mini-coéquipier
PetStickmin	Pack de bestioles Stickmin
PrisonerSkin	Détenu
Cyborg_RHM	Renaissance du bras droit
CCC_Officer	Chef du Centre d'endiguement du chaos
BeginLabel	COMMENCER
QuietLabel	CHUUUUUUT !
VentCleaning	Nettoyer conduit d'aération
CleanUp	Nettoyer
ProgressLabel	Progression :
TermsOfUseTitle	Conditions d'utilisation
PPAndToUTitle	Charte de confidentialité et Conditions d'utilisation
	
ErrorNotAuthenticated	Les serveurs d'Among Us n'ont pas pu vous authentifier.\r\n\nVous devez disposer d'un compte Among Us pour jouer en ligne (un compte invité est également accepté !).
ComePlayDiscord	Viens jouer à Among Us avec moi ! 
ShowAccountSupportID5	Afficher l'ID d'assistance du compte
ShowAccountSupportID4	Appuyez 4 fois de plus pour afficher
ShowAccountSupportID3	Ne pas partager cet ID
ShowAccountSupportID2	Ne pas cliquer pendant le stream
ShowAccountSupportID1	Me montrer absolument cet ID
SupportIDLabel	ID d'assistance : {0}
YouAreNotOnline	Vous n'êtes pas en ligne.
NoDeadBodiesFound	Aucun cadavre trouvé
SupportEmail	Pour toute demande d'assistance, veuillez contacter support@innersloth.com.
PerfectLabel	PARFAIT