KEY ID	German
LocalButton	Lokal
OnlineButton	Online
HowToPlayButton	Anleitung
FreePlayButton	Freies Spiel
PublicHeader	Öffentlich
PrivateHeader	Privat
HostHeader	Hosten
ExitButton	Verlassen
BackButton	Zurück
AvailableGamesLabel	Verfügbare Spiele
CreateGameButton	Neues Spiel
FindGameButton	Spielsuche
EnterCode	Code-Eingabe
GhostIgnoreTasks	Du bist tot. Genieße das Chaos.
GhostDoTasks	Du bist tot. Beende die Aufgaben zum Gewinnen.
TotalTasksCompleted	Erledigte Aufgaben insgesamt
GhostImpostor	Du bist tot, kannst aber noch sabotieren.
ImpostorTask	Sabotiere und lege alle um.
FakeTasks	Fake-Aufgaben:
TaskComplete	Aufgabe erledigt!
ExileTextSP	{0} war der Verräter.
ExileTextSN	{0} war nicht der Verräter.
ExileTextPP	{0} war ein Verräter.
ExileTextPN	{0} war kein Verräter.
NoExileSkip	Keiner raus (übersprungen).
NoExileTie	Keiner raus (unentschieden).
ExileTextNonConfirm	{0} ist raus.
ImpostorsRemainS	{0} Verräter übrig.
ImpostorsRemainP	{0} Verräter übrig.
Hallway	Gang
Engines	Antrieb
UpperEngine	Antrieb oben
Cafeteria	Cafeteria
Weapons	Waffen
Reactor	Reaktor
Security	Security
MedBay	Klinik
LifeSupp	O2
Nav	Navigation
LowerEngine	Antrieb unten
Electrical	Elektrik
Admin	Admin
Storage	Lager
Shields	Schilde
Comms	Kommunikation
Decontamination	Dekontamination
Launchpad	Startrampe
LockerRoom	Umkleide
Laboratory	Labor
Balcony	Balkon
Office	Büro
Greenhouse	Treibhaus
DivertPowerTo	Strom umleiten zu: {0}
AcceptDivertedPower	Stromumleitung annehmen
SubmitScan	Scannen
PrimeShields	Schild aktivieren
FuelEngines	Antrieb laden
ChartCourse	Kurs bestimmen
StartReactor	Reaktor starten
SwipeCard	Karte ziehen
ClearAsteroids	Asteroiden räumen
DownloadData	Daten-Download
UploadData	Daten-Upload
InspectSample	Probe untersuchen
EmptyChute	Rutsche leeren
EmptyGarbage	Müll entleeren
AlignEngineOutput	Antrieb ausrichten
FixWiring	Verdrahten
CalibrateDistributor	Verteiler kalibrieren
UnlockManifolds	Düsen freigeben
ResetReactor	Reaktorschmelze in
FixLights	Licht reparieren
CleanO2Filter	O2-Filter säubern
FixComms	Komm sabotiert
RestoreOxy	O2 aufgebraucht in
StabilizeSteering	Steuer stabilisieren
AssembleArtifact	Artefakt sammeln
SortSamples	Proben ordnen
MeasureWeather	Wetterdaten
EnterIdCode	ID-Code-Eingabe
BuyBeverage	Getränk kaufen
ProcessData	Daten bearbeiten
NumImpostorsS	Unter uns ist <color=#FF1919FF>1 Verräter</color>
NumImpostorsP	Unter uns sind <color=#FF1919FF>{0} Verräter</color>
Crewmate	Besatzung
Impostor	Verräter
Victory	Gewonnen
Defeat	Verloren
CrewmatesDisconnected	Besatzung größtenteils\ngetrennt
ImpostorDisconnected	Verräter getrennt
PickAnomaly	Anomalie wählen
WaterPlantsGetCan	Gießkanne genommen!
AuthOfficeOkay	Büro OK
AuthCommsOkay	Komm OK
AuthOfficeActive	Büro AKTIV
AuthCommsActive	Komm AKTIV
AuthOfficeNotActive	Büro NICHT AKTIV
AuthCommsNotActive	Komm NICHT AKTIV
SecLogEntry	{0} hat den {1}-Sensor passiert
LogNorth	Nord
LogSouthEast	Südost
LogSouthWest	Südwest
EnterName	Spitzname
SwipeCardPleaseInsert	Karte einfuehren.
SwipeCardPleaseSwipe	Karte durchziehen.
SwipeCardBadRead	Fehler. Nochmal.
SwipeCardTooFast	Zu schnell. Nochmal.
SwipeCardTooSlow	Zu langsam. Nochmal.
SwipeCardAccepted	Angenommen. Danke.
ReactorHoldToStop	Halten, um Schmelze zu stoppen
ReactorWaiting	Warten auf zweiten Nutzer
ReactorNominal	Reaktor nominal
MeetingWhoIsTitle	Wer ist der Verräter?
MeetingVotingBegins	Abstimmung in: {0} s
MeetingVotingEnds	Abstimmungsende in: {0} s
MeetingVotingResults	Abstimmungsergebnis
MeetingProceeds	Findet statt in: {0} s
MeetingHasVoted	{0} hat abgestimmt. {1} übrig.
HowToPlayText1	Among Us ist ein Spiel über Teamarbeit und Verrat.\n\nSpieler sind entweder Besatzungsmitglieder oder Verräter.
HowToPlayText2	Spielt mit 4 bis 15 Spielern online oder via lokalem WLAN!
HowToPlayText41	Als Host eines Spiels hast du die Kontrolle über das Spiel.
HowToPlayText42	Lege zuerst fest, mit wem du spielen möchtest!\n\nWenn du online mit Freunden spielen möchtest, dann stelle "Privat" ein und teile den Raum-Code.\n\nMöchtest du mit anderen aus der ganzen Welt spielen, dann stelle "Öffentlich" ein.
HowToPlayText43	Möchtest du mit mehr Aufgaben spielen? Wie wäre es mit höherem Tempo beim Gehen? Mehr Verräter? Als Host kannst du das einstellen. Stimme die Änderungen aber mit deinen Mitspielern ab.
HowToPlayText44	Sind Spieler unhöflich oder spammen, kann der Host sie als Warnung vorübergehend rauswerfen. Er kann Spieler auch für den jeweiligen Raum sperren.
HowToPlayTextMap	Die Spieler können eine persönliche Karte nutzen, um sich durchs Schiff zu bewegen.
HowToPlayTextCrew1	Ziel: Gruppen-Aufgabenleiste füllen oder Verräter enttarnen.
HowToPlayTextCrew2	Aufgaben erledigen, um Leiste zu füllen.
HowToPlayTextCrew3	Auf Sabotage des Verräters reagieren.
HowToPlayTextCrew4	Verräter gefunden? Notfall-Treffen!
HowToPlayTextCrew5	Leichen melden.
HowToPlayTextCrew6	Auf den Karten Admin und Security auf Verdächtiges achten.
HowToPlayTextImp1	Ziel: Besatzung ausschalten.
HowToPlayTextImp2	Unter die Besatzung mischen.
HowToPlayTextImp3	Durch Schächte kriechen.
HowToPlayTextImp4	Scheinbar Aufgaben erledigen.
HowToPlayTextImp5	Schiff sabotieren, Besatzung verwirren.
HowToPlayTextImp6	Opfer hinter Türen einsperren.
HowToPlayTextImp7	Besatzung zwischen Wartezeiten umbringen.
HowToPlayText5	Beim gemeinsamen Spielen in einem Raum herrscht Schweigepflicht, damit das Spiel für Besatzung und Verräter fair bleibt.\n\nWird ein Spieler vom Verräter getötet, darf der bis zum Spielende nicht reden.\n\nGeister können immer noch die zugewiesenen Aufgaben erledigen, um einen möglichen Sieg der Besatzung zu unterstützen.
HowToPlayText6	Meldet jemand eine Leiche oder beruft ein Notfall-Treffen ein, versammelt sich die Besatzung, um alles zu besprechen, was über den Verräter bekannt ist.\n\nDie Spieler können dann offen sagen, wen sie für den Verräter halten und welche Infos sie haben. Spielt ihr gemeinsam in einem Raum, dürfen Geister nicht reden, weil sie bereits wissen, wer der Verräter ist.\n\nVerräter müssen ihre Unschuld beweisen oder andere Besatzungsmitglieder beschuldigen.
HowToPlayText7	Nach der Besprechung stimmt ihr ab, wen ihr für den Verräter haltet.\n\nDer Spieler mit den meisten Stimmen wird aus dem Schiff geworfen. Also nie leichtfertig abstimmen!\n\nLiegen nicht genug Infos vor, könnt ihr als Besatzung beschließen, die Abstimmung zu überspringen, damit kein Unschuldiger rausgeworfen wird und ihr noch mehr Infos sammeln könnt.
HowToPlayText81	Übe im Modus "Freies Spiel"!
HowToPlayText82	Lege Aufgaben als Besatzungsmitglied selbst fest oder trainiere Mordstrategien als Verräter!
SettingsGeneral	Allgemein
SettingsControls	Steuerung
SettingsSound	Toneinstellungen
SettingsGraphics	Grafik
SettingsData	Daten
SettingsCensorChat	Chat-Zensur
SettingsMusic	Musik
SettingsSFX	SFX
SettingsOn	An
SettingsOff	Aus
SettingsSendTelemetry	Telemetrie senden
SettingsControlMode	Steuermodus
SettingsTouchMode	Touch
SettingsJoystickMode	Joystick
SettingsKeyboardMode	Maus und Tastatur
SettingsFullscreen	Vollbild
SettingsVSync	V-Sync
SettingsResolution	Auflösung
SettingsApply	Übernehmen
SettingsPersonalizeAds	Werbung personalisieren
SettingsLanguage	Sprache
SettingsJoystickSize	Größe
SettingsMouseMode	Maus
MatchMapName	Karte:
MatchLanguage	Chat:
MatchImpostors	Verräter:
MatchMaxPlayers	Max. Spieler:
Cancel	Abbrechen
Confirm	Bestätigen
PlayerColor	Farbe
PlayerHat	Hut
PlayerSkin	Skin
PlayerPet	Haustier
GameSettings	Spiel
GameRecommendedSettings	Empfohlen
GameCustomSettings	Benutzerdefiniert
GameMapName	Karte
GameNumImpostors	# Verräter
GameNumMeetings	# Notfall-Treffen
GameDiscussTime	Besprechungsdauer
GameVotingTime	Abstimmungsdauer
GamePlayerSpeed	Spielertempo
GameCrewLight	Besatzungssicht
GameImpostorLight	Verrätersicht
GameKillCooldown	Kill-Wartezeit
GameKillDistance	Kill-Distanz
GameCommonTasks	# Aufgaben für alle
GameLongTasks	# Lange Aufgaben
GameShortTasks	# Kurze Aufgaben
GameEmergencyCooldown	Notfall-Treffen-Wartezeit
GameSecondsAbbrev	{0}s
GameConfirmImpostor	Rauswürfe bestätigen
GameVisualTasks	Visuelle Aufgaben
GameAnonymousVotes	Anonym abstimmen
GameTaskBarMode	Aufgabenleiste-Updates
SettingNormalTaskMode	Immer
SettingMeetingTaskMode	Treffen
SettingInvisibleTaskMode	Nie
Limit	Limit
RoomCode	Code
LeaveGame	Spiel verlassen
ReturnToGame	Zurück zum Spiel
LocalHelp	Verbindungsprobleme?\n\n● Alle müssen mit demselben WLAN-Namen\nverbunden sein.\n● Alle müssen dieselbe Version nutzen\n(oben links).\n● Das WLAN-Signal muss stark genug sein.\n● Es hilft, wenn ein anderer Spieler hostet. \n● Es hilft, die App neu zu starten ...\n● Es hilft, das Smartphone neu zu starten ...\n● Weitere Probleme? Teile es uns auf Discord mit! 
OnlineHelp	Wie funktioniert das?\n\n● Hostest du ein Spiel, siehst du neben dem Start-Button einen Spiel-Code.\n● Teile den Spiel-Code mit Freunden, um einen privaten Raum zu erstellen.\n● Oder tippe "Privat" an, um den Raum für die "Spielsuche" öffentlich zu machen.\n● Der Host kann Spieler sperren oder rauswerfen,\n wenn ein Chat verfügbar ist.\n● Weitere Probleme? Teile es uns auf Discord mit! 
EmergencyCount	BESATZUNGSMITGLIED {0} HAT\n\n\n\nNOTFALL-TREFFEN ÜBRIG
EmergencyNotReady	BESATZUNGSMITGLIEDER MÜSSEN\n\n\n\nBIS ZUM NÄCHSTEN NOTFALL WARTEN
EmergencyDuringCrisis	NOTFALL-TREFFEN KÖNNEN NICHT IN\nKRISEN EINBERUFEN WERDEN
EmergencyRequested	NOTFALL-TREFFEN ERBETEN\nWARTEN AUF HOST
AdPolicyTitle	Richtlinien für Werbung
AdPolicyText	Dürfen wir deine persönlichen Daten verwenden, um Werbeanzeigen auf dich zuzuschneiden? Wenn du auf Ja klickst, sammeln unsere Werbepartner wie Google AdMob und Unity Ads automatisch Daten und nutzen Geräte-IDs und Cookies für personalisierte Anzeigen. Wenn du auf Nein klickst, bekommst du weiterhin nicht personalisierte Anzeigen zu sehen. Um alle Anzeigen loszuwerden, empfehlen wir den Kauf des werbefreien Upgrades [httpstore]hier[], dann sehen auch deine Freunde keine Anzeigen, wenn du hostest! Um mehr über den Datenschutz bei uns und unseren Werbepartnern zu erfahren, lies bitte unsere [https://innersloth.com/privacy.php]Datenschutzrichtlinie[]. Du kannst deine Entscheidung jederzeit im Menü Einstellungen unter „Daten“ ändern.
Accept	Annehmen
RemoveAds	Werbefrei
PlainYes	Ja
PlainNo	Nein
PrivacyPolicyTitle	Datenschutzrichtlinie
PrivacyPolicyText	Innersloth verarbeitet für Among Us Personendaten. Bitte lies unsere <link="https://innersloth.com/privacy.php">Datenschutzrichtlinie</link>, um mehr zu unserem Umgang mit Datenschutz zu erfahren. Die Einstellungen für deine persönlichen Daten für Among Us kannst du unter "Daten" verwalten.
ManageDataButton	Datensammlung verwalten
UnderstandButton	Verstanden
WaterPlants	Pflanzen gießen
WeatherEta	ETA: {0} s
WeatherComplete	Erledigt
RunDiagnostics	Diagnose ausführen
SettingShort	Kurz
SettingMedium	Mittel
SettingLong	Lang
SamplesPress	Zum Starten drucken
SamplesAdding	Reagenz hinzugeben
SamplesSelect	Anomalie wählen
SamplesThanks	Vielen Dank!
SamplesComplete	Test beendet
AstDestroyed	Zerstört: {0}
TaskTestTitle	Aufgabentester 2000
BeginDiagnostics	Diagnose starten
UserLeftGame	{0} hat Spiel verlassen.
GameStarting	Start in {0}
ChatRateLimit	Zu schnell. Warte {0} Sekunden.
Tasks	Aufgaben
MedscanRequested	Scan erbeten
MedscanWaitingFor	Warten auf {0}
MedscanCompleted	Scan fertig!
MedscanCompleteIn	Scan fertig in {0}.
StatsTitle	Statistiken
StatsBodiesReported	Gemeldete Leichen:\t
StatsEmergenciesCalled	Einberufene Treffen:\t
StatsTasksCompleted	Einzelne erledigte Aufgaben:\t
StatsAllTasksCompleted	Aufgabenleiste vervollständigt:\t
StatsSabotagesFixed	Behobene Sabotagen:\t
StatsImpostorKills	Verräter-Kills:\t\t
StatsTimesMurdered	Anzahl der Tode:\t
StatsTimesEjected	Anzahl der Rauswürfe:\t\t
StatsCrewmateStreak	Besatzungsserie:\t
StatsGamesImpostor	Verräterrolle:\t
StatsGamesCrewmate	Besatzungsrolle:\t
StatsGamesStarted	Gestartete Spiele:\t
StatsGamesFinished	Beendete Spiele:\t
StatsImpostorVoteWins	Verräter-Abstimmungssiege:\t
StatsImpostorKillsWins	Verräter-Kill-Siege:\t
StatsImpostorSabotageWins	Verräter-Sabotagesiege:\t
StatsCrewmateVoteWins	Besatzung-Abstimmungssiege:\t
StatsCrewmateTaskWins	Besatzung-Aufgabensiege:\t
MonitorOxygen	Baumkontrolle
StoreArtifacts	Artefakte packen
FillCanisters	Kanister füllen
InsertKeys	Aufschließen
ResetSeismic	Seismo-Stabilisatoren zurücksetzen
SeismicHoldToStop	Halten, um Seismo-Stabilisatoren zu aktivieren
SeismicNominal	Seismische Aktivität nominal
ScanBoardingPass	Bordkarte scannen
FixWeatherNode	Repariere Wettermodul
OpenWaterways	Wasser aufdrehen
ReplaceWaterJug	Wasserfass ersetzen
RepairDrill	Bohrer reparieren
AlignTelescope	Teleskop ausrichten
RecordTemperature	Temperatur aufzeichnen
RebootWifi	WLAN-Neustart
WifiRebootRequired	Neustart nötig
WifiPleaseWait	Bitte warten
WifiPleaseReturnIn	Bitte wiederkommen in {0}
WifiPleasePowerOn	Bitte einschalten
WifiRebootComplete	Neustart beendet
Outside	Außen
Dropship	Landekapsel
Decontamination2	Dekontamination
Specimens	Artenraum
BoilerRoom	Heizraum
GameOverImpostorDead	Eigentlich hätte jetzt die Besatzung gewonnen, weil der Verräter tot ist. Beim freien Spiel werden aber alle wiederbelebt.
GameOverImpostorKills	Eigentlich hätte jetzt der Verräter gewonnen, weil die Besatzung nicht mehr gewinnen kann. Beim freien Spiel werden aber alle wiederbelebt.
GameOverTaskWin	Eigentlich hätte jetzt die Besatzung gewonnen, weil die Aufgabenleiste voll ist. Beim freien Spiel werden aber neue Aufgaben erteilt.
GameOverSabotage	Eigentlich hätte jetzt der Verräter aufgrund der kritischen Sabotage gewonnen. Stattdessen schalten wir einfach ab.
HowToPlayText2Switch	Spielt mit eurer Nintendo Switch Online-Mitgliedschaft oder über das lokale WLAN mit 4 bis 15 Spielern online!
VentDirection	Lüftungsrichtung
VentMove	Durch Schacht gehen
MenuNavigate	Navigieren
NsoError	Verbindung zum Netzwerk fehlgeschlagen.
ErrorServerOverload	Die Server von Among Us sind überlastet.\r\n\r\nSorry! Bitte probiere es später erneut!
ErrorIntentionalLeaving	Nach einem absichtlichen Verbindungsabbruch kannst du {0} Minute(n) lang keinem weiteren Spiel beitreten.
ErrorFocusLost	Deine Verbindung wurde getrennt, da Among Us von einer anderen Anwendung angehalten wurde.
ErrorBanned	Du wurdest für {0} gesperrt.\r\n\r\nDiesen Raum kannst du nicht mehr betreten.
ErrorKicked	Du wurdest aus {0} rausgeworfen.\r\n\r\nDu kannst diesen Raum erneut betreten, wenn er noch nicht gestartet wurde.
ErrorBannedNoCode	Du wurdest für diesen Raum gesperrt.\r\n\r\nDiesen Raum kannst du nicht mehr betreten.
ErrorKickedNoCode	Du wurdest aus diesem Raum rausgeworfen.\r\n\r\nDu kannst diesen Raum erneut betreten, wenn er noch nicht gestartet wurde.
ErrorHacking	Du wurdest aufgrund von Hacking gesperrt.\r\n\r\nLass das bitte.
ErrorFullGame	Das Spiel, dem du beitreten wolltest, ist voll.\r\n\r\nKontaktiere den Host, um zu fragen, ob du in der nächsten Runde dabei sein kannst.
ErrorStartedGame	Das Spiel, dem du beitreten wolltest, hat bereits begonnen.\r\n\r\nKontaktiere den Host, um zu fragen, ob du in der nächsten Runde dabei sein kannst.
ErrorNotFoundGame	Das von dir gesuchte Spiel konnte nicht gefunden werden.
ErrorInactivity	Der Server hat dieses Spiel gestoppt. Möglicherweise aufgrund von Inaktivität.
ErrorGenericOnlineDisconnect	Deine Verbindung zum Server wurde getrennt.\r\nPassiert dies öfter, dann solltest du die Signalstärke deiner Netzwerkverbindung überprüfen.\r\nDies kann aber auch ein Serverproblem sein.
ErrorGenericLocalDisconnect	Deine Verbindung zum Host wurde getrennt.\r\n\r\nPassiert dies öfter, dann solltest du die Signalstärke deiner WLAN-Verbindung überprüfen.
ErrorInvalidName	Der Server hat diesen Nutzernamen abgelehnt: {0}.
ErrorUnknown	Deine Verbindung zum Server wurde aufgrund eines unbekannten Problems getrennt.
ErrorIncorrectVersion	Du nutzt eine ältere Version der Software.\r\n\r\nBitte aktualisiere deine Version, um mit anderen spielen zu können.
	
ServerNA	Nordamerika
ServerEU	Europa
ServerAS	Asien
ServerSA	Südamerika
LangEnglish	English
LangFrench	Français
LangItalian	Italiano
LangGerman	Deutsch
LangSpanish	Español
LangSpanishLATAM	Español (Latinoamérica)
LangBrazPort	Português (Brasil)
LangPort	Português
LangRussian	Русский
LangJapanese	日本語
LangKorean	한국어
LangDutch	Nederlands
LangFilipino	Bisaya
PlayerName	Spieler
MyTablet	Mein Tablet
Headquarters	Hauptquartier
DownloadTestEstTimeS	Geschätzte Zeit: {0}s
DownloadTestEstTimeMS	Geschätzte Zeit: {0}m {1}s
DownloadTestEstTimeHMS	Geschätzte Zeit: {0}hr {1}m {2}s
DownloadTestEstTimeDHMS	Geschätzte Zeit: {0}d {1}hr {2}m {3}s
DownloadComplete	Fertig
GrabCoffee	HOL DIR EINE TASSE KAFFEE
TakeBreak	MACH EINE PAUSE
DontNeedWait	DU BRAUCHST NICHT ZU WARTEN
DoSomethingElse	MACH SOLANGE ETWAS ANDERES
NodeTB	Knoten_TB
NodeIRO	Knoten_IRO
NodeGI	Knoten_GI
NodePD	Knoten_PD
NodeCA	Knoten_CA
NodeMLG	Knoten_MLG
Vending	AUTOMAT
OtherLanguage	Andere
ImposterAmtAny	1-3
	
VitalsORGN	ORGN
VitalsBLUE	BLAU
VitalsRED	ROT
VitalsBRWN	BRN
VitalsGRN	GRÜN
VitalsPINK	PINK
VitalsWHTE	WSS
VitalsYLOW	GELB
VitalsBLAK	SW
VitalsPURP	LILA
VitalsCYAN	TRKS
VitalsLIME	LIM
ColorOrange	ORANGE
ColorBlue	BLAU
ColorRed	ROT
ColorBrown	BRAUN
ColorGreen	GRÜN
ColorPink	PINK
ColorWhite	WEISS
ColorYellow	GELB
ColorBlack	SCHWARZ
ColorPurple	LILA
ColorCyan	TÜRKIS
ColorLime	LIMETTE
ColorMaroon	ROTBRAUN
ColorRose	ROSÉ
ColorBanana	BANANE
ColorGray	GRAU
ColorTan	SAND
ColorCoral	KORALLE
MedID	ID:
MedC	F:
MedHT	GR:
MedBT	BG:
MedWT	GW:
MedETA	ETA {0}
MedHello	HALLO!
LobbySizeWarning	Among Us kann mit 4 Spielern gespielt \nwerden, aber 5 oder mehr Spieler werden empfohlen.\n\nRunden mit 4 Spielern sind schnell zu Ende, \nund der Verräter gewinnt dabei oft.
Okay	Okay
OkayDontShow	O. K., nicht mehr zeigen
Nevermind	Egal
CamEast	Osten
CamCentral	Mitte
CamNortheast	Nordosten
CamSouth	Süden
CamSouthwest	Südwest
CamNorthwest	Nordwesten
LoadingFailed	Laden fehlgeschlagen:
PetFailFetchData	Haustierdaten nicht abrufbar
BadResult	FEHLER
More	{0} MEHR
Processing	In Bearbeitung
ExitGame	Spiel verlassen
WaitingForHost	Warten auf Host
LeftGameError	{0} hat das Spiel wegen eines Fehlers verlassen.
PlayerWasBannedBy	{0} wurde von {1} gesperrt.
PlayerWasKickedBy	{0} wurde von {1} rausgeworfen.
Dummy	Dummy
Bad	FALSCH
Status	Status: 
Fine	RICHTIG
OK	OK
SecondsAbbv	{0}s
PetTryOn	Deine Auswahl!
DataPolicyWhat	Was wird gesammelt?
	
	
	
VaultRoom	Tresorraum
Cockpit	Cockpit
Armory	Arsenal
Kitchen	Küche
ViewingDeck	Aussichtsdeck
HallOfPortraits	Porträthalle
Medical	Arztpraxis
CargoBay	Laderaum
Ventilation	Lüftung
Showers	Duschen
Engine	Antriebsraum
Brig	Flur
MeetingRoom	Tagungsraum
Records	Archiv
Lounge	Lounge
GapRoom	Plattform
MainHall	Hauptflur
	
PolishRuby	Rubin polieren
ResetBreakers	Schalter zurückstellen
Decontaminate	Dekontaminieren
MakeBurger	Burger machen
UnlockSafe	Safe öffnen
SortRecords	Archiv sortieren
PutAwayPistols	Pistolen verstauen
PutAwayRifles	Gewehre verstauen
FixShower	Dusche reparieren
CleanToilet	Toilette putzen
DressMannequin	Puppe anziehen
PickUpTowels	Handtücher aufsammeln
RewindTapes	Kassetten zurückspulen
StartFans	Ventilatoren starten
DevelopPhotos	Fotos entwickeln
GetBiggolSword	Biggol-Schwert holen
StopCharles	Unfall verhindern
	
RevealCode	Code aufdecken
DirtyHeader	SCHMUTZIG
AuthLeftOkay	Linke Seite OK
AuthRightOkay	Rechte Seite OK
AuthLeftActive	Linke Seite AKTIV
AuthRightActive	Rechte Seite AKTIV
AuthLeftNotActive	Linke Seite NICHT AKTIV
AuthRightNotActive	Rechte Seite NICHT AKTIV
EngagementScreen	Zum Start beliebigen Button drücken.
DeleteButton	Löschen
QuickChat	Quick-Chat
QCLocationLaptop	Laptop
QCLocationSkeld	Skeld
QCLocationMira	Mira 
QCLocationPolus	Polus
QCSystemsStart	Start
QCSystemsKick	Raus
QCCrewI	Ich
QCCrewMe	mich/mir
QCCrewNoOne	Niemand
QCAccAKilledB	{0} tötete {1}
QCAccAKilledBNeg	{0} tötete {1} nicht
QCAccAIsSuspicious	{0} ist verdächtig
QCAccAIsSuspiciousNeg	{0} ist harmlos
QCAccASawBVent	{0} hat {1} in einem Schacht gesehen.
QCAccASawBVentNeg	{0} hat {1} nicht in einem Schacht gesehen.
QCAccAWasChasingB	{0} verfolgte {1}.
QCAccAWasChasingBNeg	{0} verfolgte {1} nicht.
QCAccAIsLying	{0} lügt.
QCAccAIsLyingNeg	{0} sagt die Wahrheit.
QCAccVoteA	Stimme für {0}.
QCAccVoteANeg	Keine Stimme für {0}.
QCAccADidntReport	{0} meldete die Leiche nicht.
QCResYes	Ja
QCResNo	Nein
QCResDontKnow	Ich weiß nicht.
QCResDontKnowNeg	Vielleicht
QCResAWas	{0} war
QCResAWasNeg	{0} war nicht
QCResADid	{0} tat
QCResADidNeg	{0} tat nicht
QCResVote	Abstimmen
QCResVoteNeg	Abstimmung überspringen
QCResAWasAtB	{0} war bei {1}
QCResAWasAtBNeg	{0} war nicht bei {1}
QCResRip	RIP
QCResRipNeg	Wirf
QCResLies	Lüge
QCResLiesNeg	Okay
QCQstWhere	Wo?
QCQstWho	Wer?
QCQstWhoWasWith	Wer war bei {0}?
QCQstWhatWasADoing	Was tat {0}?
QCQstWhoFixedA	Wer reparierte {0}?
QCQstWhereWasA	Wo war {0}?
QCQstBodyOrMeeting	War das eine Leiche oder ein Notfall-Meeting?
QCStaASawB	{0} sah {1}.
QCStaAWasWithB	{0} war bei {1}.
QCStaADidB	{0} erledigte {1}.
QCStaASelfReported	{0} meldete sich selbst.
QCStaDoubleKill	Es war ein Doppelmord.
QCStaWasSelfReport	Es war eine Selbstmeldung.
QCStaPleaseDoTasks	Bitte erfüll deine Aufgaben.
QCStaBodyWasInA	Die Leiche war in {0}.
QCStaACalledMeeting	{0} berief ein Meeting ein.
QCLocation	Ort
QCSystems	Systeme
QCCrew	Besatzung
QCAccusation	Anklage
QCResponse	Antwort
QCQuestion	Frage
QCStatements	Aussagen
ChatType	Chat-Typ
QuickChatOnly	Nur Quick-Chat
FreeChatOnly	Nur Free-Chat
FreeOrQuickChat	Free- oder Quick-Chat
DateOfBirth	Geburtsdatum
DateOfBirthEnter	Bitte gib dein Geburtsdatum ein:
Month	Monat:
Day	Tag:
Year	Jahr:
January	Januar
February	Februar
March	März
April	April
May	Mai
June	Juni
July	Juli
August	August
September	September
October	Oktober
November	November
December	Dezember
Submit	Senden
	
QCAccAKilledB_QCCrewMe_ANY	Ich habe {1} getötet.
QCAccAKilledB_QCCrewMe_QCCrewNoOne	Ich habe niemanden getötet.
QCAccAKilledB_QCCrewMe_QCCrewMe	
QCAccAKilledB_ANY_QCCrewMe	{0} hat mich getötet.
QCAccAKilledB	{0} hat {1} getötet.
QCAccAKilledB_ANY_QCCrewNoOne	{0} hat niemanden getötet.
QCAccAKilledB_QCCrewNoOne_QCCrewMe	Niemand hat mich getötet.
QCAccAKilledB_QCCrewNoOne_ANY	Niemand hat {1} getötet.
QCAccAKilledB_QCCrewNoOne_QCCrewNoOne	Niemand hat jemanden getötet.
QCAccAKilledBNeg_QCCrewMe_ANY	Ich habe {1} nicht getötet.
QCAccAKilledBNeg_QCCrewMe_QCCrewNoOne	Ich habe niemanden getötet.
QCAccAKilledBNeg_QCCrewMe_QCCrewMe	Ich habe mich nicht selbst getötet.
QCAccAKilledBNeg_ANY_QCCrewMe	{0} hat mich nicht getötet.
QCAccAKilledBNeg	{0} hat {1} nicht getötet.
QCAccAKilledBNeg_ANY_QCCrewNoOne	{0} hat niemanden getötet.
QCAccAKilledBNeg_QCCrewNoOne_QCCrewMe	
QCAccAKilledBNeg_QCCrewNoOne_ANY	
QCAccAKilledBNeg_QCCrewNoOne_QCCrewNoOne	
QCAccAIsSuspicious_QCCrewMe	Ich bin verdächtig.
QCAccAIsSuspicious	{0} ist verdächtig.
QCAccAIsSuspicious_QCCrewNoOne	Niemand ist verdächtig.
QCAccAIsSuspiciousNeg_QCCrewMe	Ich bin harmlos.
QCAccAIsSuspiciousNeg	{0} ist harmlos.
QCAccAIsSuspiciousNeg_QCCrewNoOne	Alle sind gefährlich.
QCAccASawBVent_QCCrewMe_ANY	Ich habe {1} in einem Schacht gesehen.
QCAccASawBVent_QCCrewMe_QCCrewNoOne	Ich habe niemanden in einem Schacht gesehen.
QCAccASawBVent_QCCrewMe_QCCrewMe	
QCAccASawBVent_ANY_QCCrewMe	{0} hat mich in einem Schacht sehen.
QCAccASawBVent	{0} hat {1} in einem Schacht gesehen.
QCAccASawBVent_ANY_QCCrewNoOne	{0} hat niemanden in einem Schacht gesehen.
QCAccASawBVent_QCCrewNoOne_QCCrewMe	Niemand hat mich in einem Schacht gesehen.
QCAccASawBVent_QCCrewNoOne_ANY	Niemand hat {1} in einem Schacht gesehen.
QCAccASawBVent_QCCrewNoOne_QCCrewNoOne	Niemand hat jemanden in einem Schacht gesehen.
QCAccASawBVentNeg_QCCrewMe_ANY	Ich habe {1} nie in einem Schacht gesehen.
QCAccASawBVentNeg_QCCrewMe_QCCrewNoOne	Ich habe nie jemanden in einem Schacht gesehen.
QCAccASawBVentNeg_QCCrewMe_QCCrewMe	
QCAccASawBVentNeg_ANY_QCCrewMe	{0} hat mich nie in einem Schacht gesehen.
QCAccASawBVentNeg	{0} hat {1} nie in einem Schacht gesehen.
QCAccASawBVentNeg_ANY_QCCrewNoOne	{0} hat nie jemanden in einem Schacht gesehen.
QCAccASawBVentNeg_QCCrewNoOne_QCCrewMe	Niemand hat mich je in einem Schacht gesehen.
QCAccASawBVentNeg_QCCrewNoOne_ANY	Niemand hat {1} in einem Schacht gesehen.
QCAccASawBVentNeg_QCCrewNoOne_QCCrewNoOne	Niemand hat jemals jemanden in einem Schacht gesehen.
QCAccAWasChasingB_QCCrewMe_ANY	Ich habe {1} verfolgt.
QCAccAWasChasingB_QCCrewMe_QCCrewNoOne	Ich habe niemanden verfolgt.
QCAccAWasChasingB_QCCrewMe_QCCrewMe	
QCAccAWasChasingB_ANY_QCCrewMe	{0} hat mich verfolgt.
QCAccAWasChasingB	{0} hat {1} verfolgt.
QCAccAWasChasingB_ANY_QCCrewNoOne	{0} hat niemanden verfolgt.
QCAccAWasChasingB_QCCrewNoOne_QCCrewMe	Niemand hat mich verfolgt.
QCAccAWasChasingB_QCCrewNoOne_ANY	Niemand hat {1} verfolgt.
QCAccAWasChasingB_QCCrewNoOne_QCCrewNoOne	Niemand hat jemanden verfolgt.
QCAccAWasChasingBNeg_QCCrewMe_ANY	Ich habe {1} nicht verfolgt.
QCAccAWasChasingBNeg_QCCrewMe_QCCrewNoOne	Ich habe niemanden verfolgt.
QCAccAWasChasingBNeg_QCCrewMe_QCCrewMe	
QCAccAWasChasingBNeg_ANY_QCCrewMe	{0} hat mich nicht verfolgt.
QCAccAWasChasingBNeg	{0} hat {1} nicht verfolgt.
QCAccAWasChasingBNeg_ANY_QCCrewNoOne	{0} hat niemanden verfolgt.
QCAccAWasChasingBNeg_QCCrewNoOne_QCCrewMe	
QCAccAWasChasingBNeg_QCCrewNoOne_ANY	
QCAccAWasChasingBNeg_QCCrewNoOne_QCCrewNoOne	
QCAccAIsLying_QCCrewMe	Ich lüge.
QCAccAIsLying	{0} lügt.
QCAccAIsLying_QCCrewNoOne	Niemand lügt.
QCAccAIsLyingNeg_QCCrewMe	Ich sage die Wahrheit.
QCAccAIsLyingNeg	{0} sagt die Wahrheit.
QCAccAIsLyingNeg_QCCrewNoOne	Niemand sagt die Wahrheit.
QCAccVoteA_QCCrewMe	Stimmt für mich.
QCAccVoteA	Stimmt für {0}.
QCAccVoteA_QCCrewNoOne	Wählt niemanden raus.
QCAccVoteANeg_QCCrewMe	Stimmt nicht für mich.
QCAccVoteANeg	Stimmt nicht für {0}.
QCAccVoteANeg_QCCrewNoOne	
QCAccADidntReport_QCCrewMe	Ich habe die Leiche nicht gemeldet.
QCAccADidntReport	{0} hat die Leiche nicht gemeldet.
QCAccADidntReport_QCCrewNoOne	
QCResAWas_QCCrewMe	Ich.
QCResAWas	{0}.
QCResAWas_QCCrewNoOne	Niemand.
QCResAWasNeg_QCCrewMe	Ich nicht.
QCResAWasNeg	{0} nicht.
QCResAWasNeg_QCCrewNoOne	
QCResADid_QCCrewMe	Ich.
QCResADid	{0}.
QCResADid_QCCrewNoOne	Niemand.
QCResADidNeg_QCCrewMe	Ich nicht.
QCResADidNeg	{0} nicht.
QCResADidNeg_QCCrewNoOne	
QCResAWasAtB_QCCrewMe_ANY	Ich war dort: {1}.
QCResAWasAtB	{0} war dort: {1}.
QCResAWasAtB_QCCrewNoOne_ANY	Niemand war dort: {1}.
QCResAWasAtBNeg_QCCrewMe_ANY	Ich war nicht dort: {1}.
QCResAWasAtBNeg	{0} war nicht dort: {1}.
QCResAWasAtBNeg_QCCrewNoOne_ANY	
QCQstWhoWasWith_QCCrewMe	Wer war bei mir?
QCQstWhoWasWith	Wer war bei {0}?
QCQstWhoWasWith_QCCrewNoOne	Wer war allein?
QCQstWhatWasADoing_QCCrewMe	
QCQstWhatWasADoing	Was hat {0} getan?
QCQstWhatWasADoing_QCCrewNoOne	
QCQstWhereWasA_QCCrewMe	
QCQstWhereWasA	Wo war {0}?
QCQstWhereWasA_QCCrewNoOne	
QCStaASawB_QCCrewMe_ANY	Ich habe {1} gesehen.
QCStaASawB_QCCrewMe_QCCrewNoOne	Ich habe niemanden gesehen.
QCStaASawB_QCCrewMe_QCCrewMe	
QCStaASawB_ANY_QCCrewMe	{0} hat mich gesehen.
QCStaASawB	{0} hat {1} gesehen.
QCStaASawB_ANY_QCCrewNoOne	{0} hat niemanden gesehen.
QCStaASawB_QCCrewNoOne_QCCrewMe	Niemand hat mich gesehen.
QCStaASawB_QCCrewNoOne_ANY	Niemand hat {1} gesehen.
QCStaASawB_QCCrewNoOne_QCCrewNoOne	Niemand hat jemanden gesehen.
QCStaAWasWithB_QCCrewMe_ANY	Ich war bei {1}.
QCStaAWasWithB_QCCrewMe_QCCrewNoOne	Ich war bei niemandem.
QCStaAWasWithB_QCCrewMe_QCCrewMe	
QCStaAWasWithB_ANY_QCCrewMe	{0} war bei mir.
QCStaAWasWithB	{0} war bei {1}.
QCStaAWasWithB_ANY_QCCrewNoOne	{0} war bei niemandem.
QCStaAWasWithB_QCCrewNoOne_QCCrewMe	Niemand war bei mir.
QCStaAWasWithB_QCCrewNoOne_ANY	Niemand war bei {1}.
QCStaAWasWithB_QCCrewNoOne_QCCrewNoOne	Niemand war bei jemandem.
QCStaADidB_QCCrewMe_ANY	Ich habe {1} erledigt.
QCStaADidB	{0} hat {1} erledigt.
QCStaADidB_QCCrewNoOne_ANY	Niemand hat {1} erledigt.
QCStaASelfReported_QCCrewMe	Ich habe mich selbst gemeldet.
QCStaASelfReported	{0} hat sich selbst gemeldet.
QCStaASelfReported_QCCrewNoOne	Niemand hat sich selbst gemeldet.
QCStaACalledMeeting_QCCrewMe	Ich habe ein Meeting einberufen.
QCStaACalledMeeting	{0} hat ein Meeting einberufen.
QCStaACalledMeeting_QCCrewNoOne	Niemand hat ein Meeting einberufen.
QCMore	MEHR
SecurityLogsSystem	Security-Logs
SecurityCamsSystem	Security-Kameras
AdminMapSystem	Admin-Karte
VitalsSystem	Lebensmonitor
EngagementScreenSignIn	Anmeldung läuft ...
SaveGameOutOfSpaceConfirm	Fortfahren
EngagementScreen	Zum Start beliebigen Button drücken.
SaveGameOutOfSpaceMessage	Möchtest du fortfahren, ohne zu speichern?
SaveGameOutOfSpaceConfirm	Fortfahren
SaveGameOutOfSpaceCancel	Erneut versuchen
Success	Erfolg!
Failed	Fehlschlag!
ErrorCreate	Beim Anlegen deines Kontos ist etwas schiefgegangen. Bitte versuche es später wieder.
SuccessCreate	Du hast erfolgreich ein Konto angelegt!
Close	Schließen
ErrorLogIn	Bei der Anmeldung bei deinem Konto ist etwas schiefgegangen. Bitte versuche es später wieder.
SuccessLogIn	Du hast dich erfolgreich bei deinem Konto angemeldet!
AccountInfo	KONTO-INFO
Account	KONTO
UserName	BENUTZERNAME
Height	Größe
Weight	Gewicht
SignIn	Anmelden
CreateAccount	Konto anlegen
RequestPermission	Erlaubnis einholen
RandomizeName	Zufälliger Name
AccountLinking	Kontoverknüpfung
ChangeName	Namen ändern
LogOut	Abmelden
GuardianWait	Du brauchst die Erlaubnis deiner Erziehungsberechtigten, um den Free-Chat zu nutzen und deinen Benutzernamen zu ändern.
EmailEdit	E-Mail bearbeiten
EmailResend	E-Mail erneut senden
GuestContinue	Als Gast fortfahren
GuardianEmailSent	E-Mail an Erziehungsberechtigte*n gesendet
GuardianCheckEmail	Erinnere deine Erziehungsberechtigten daran, ihre E-Mails zu lesen und alle Funktionen des Spiels freizuschalten.
EditName	Namen bearbeiten
Name	Name
CreateAccountQuestion	Konto anlegen?
DoYouWantCreate	Möchtest du ein Konto anlegen?
PermissionRequired	Erlaubnis erforderlich
NeedPermissionText	Wir müssen deine Erziehungsberechtigten (per E-Mail) um die Erlaubnis bitten, fortzufahren. Wenn sie zustimmen, kannst du den Free-Chat online nutzen und deinen Benutzernamen ändern. Bitte Erwachsene, dir dabei zu helfen!
GuardianEmailTitle	E-Mail-Adresse des/der Erziehungsberechtigten
Send	Senden
NewEmail	Neue E-Mail-Adresse
ConfirmEmail	E-Mail-Adresse bestätigen
EditEmail	E-Mail-Adresse bearbeiten
Loading	Wird geladen
Welcome	WILLKOMMEN
GuardianEmail	[E-Mail-Adresse des/der Erziehungsberechtigten]
	
BanButton	SPERREN
KickButton	RAUS
ReportButton	MELDEN
ReportConfirmation	Du hast den folgenden Benutzer erfolgreich gemeldet.
ReportBadName	Unangebrachter Name
ReportBadChat	Unangebrachte Chatnachricht
ReportHacking	Hacking/Cheating
ReportHarassment	Belästigung/Fehlverhalten
ReportWhy	Warum meldest du diesen Nutzer?
DLLNotFoundAccountError	Beim Versuch, dich mit dem Online-Dienst zu verbinden, ist etwas schiefgegangen. Bis das Problem behoben ist, kannst du nur im Modus Lokal oder Freies Spiel spielen. Versuche es später noch einmal.
ContinueOffline	Offline spielen
WantToLogIn	Du bist zurzeit bei keinem Konto angemeldet.
GoOffline	Offline gehen
PlayAsGuest	Als Gast spielen
LogInTitle	Bei deinem Konto anmelden
LogInInfoText	– Mit einem Gastkonto kannst du online spielen, ohne ein Konto zu verknüpfen; es kann allerdings nicht wiederhergestellt werden, wenn du das Gerät wechselst oder Among Us deinstallierst.\n– Wenn du dich mit einem eigenen Benutzerkonto registrierst, kannst du dich später jederzeit erneut anmelden. Wenn du kein Konto hast, wird automatisch eins für dich angelegt.
LogInInfoTextSwitch	Wenn du dich mit einem eigenen Benutzerkonto registrierst, kannst du dich später jederzeit erneut anmelden. Wenn du kein Konto hast, wird automatisch eins für dich angelegt.
ControllerDisconnectedMessage	Controller getrennt
FollowUs	Folge uns!
	
QuickChatInstructionsStart	Dein Chat im Spiel ist auf „Nur Quick-Chat“ eingestellt.
QuickChatInstructionsChild	Du brauchst die Erlaubnis eines/einer Erziehungsberechtigten, um auf die Vollversion des Chats zuzugreifen.
QuickChatInstructionsGuest	Du musst angemeldet sein, um das zu ändern.
QuickChatInstructionsFull	Du kannst das im Menü Einstellungen ändern.
	
SwitchEShopBrowseAll	Schau dir alle Objekte im Nintendo eShop an.
	
Download	Download
Upload	Upload
pk05_davehat	Daves Hut
pk05_Ellie	Ellie
pk05_Svenhat	Svens Hut
pk05_Burthat	Burts Hut
pk05_Ellryhat	Ellrys Iro
pk05_monocles	Doppelmonokel
pk05_cheesetoppat	Käsezylinder
pk05_Macbethhat	Mr. Macbeths Zylinder
pk05_HenryToppat	Henrys Zylinder
pk05_EllieToppat	Ellies Zylinder
pk05_GeoffreyToppat	Geoffreys Zylinder
	
	
InsufficientStorageError	Der Speicherplatz reicht nicht aus, um das Paket herunterzuladen. Schaffe bitte Platz auf deinem Gerät und versuche es erneut.
NetworkError	Ein Netzwerkfehler ist aufgetreten. Bitte überprüfe deine Verbindungseinstellungen und versuche es erneut.
OtherDownloadError	Ein Fehler ist aufgetreten: {0}
DownloadingLabel	Herunterladen von {0}
DownloadSizeLabel	Download-Größe: {0} MB
	
TimeRemaining	Verbleibende Zeit: {0}
DeadLabel	TOT
	
InviteFriends	Freunde einladen
	
NutriLabel	NAHRUNG
CO2Label	CO2
RADLabel	RAD
WaterLabel	WASSER
	
DoorlogLabel	TÜR-LOG
VitalsLabel	LEBEN
OptionsLabel	ANPASSEN
ProceedLabel	WEITER
StartLabel	START
UseLabel	NUTZEN
PlayAgain	ERNEUT SPIELEN
QuitLabel	BEENDEN
ReportLabel	MELDEN
SabotageLabel	SABOTAGE
VentLabel	SCHACHT
KillLabel	KILL
DiscussLabel	BESPRECHUNG!
SkippedVoting	ÜBERSPRUNGEN
SkipVoteLabel	ÜBERSPRINGEN
EmergencyMeeting	NOTFALL-MEETING
BodyReported	LEICHE GEMELDET
SkinLabel	SKINS
HatLabel	HÜTE
PetLabel	HAUSTIERE
AnnouncementLabel	ANKÜNDIGUNGEN
	
UploadingLabel	UPLOAD LÄUFT
ConnectionLabel	Verbindung:
NoneLabel	KEINE
PoorLabel	SCHLECHT
GoodLabel	GUT
LogLabel	LOG
ReadingLabel	ABLESEN
WeatherDataDownload	WETTERDATEN-DOWNLOAD
AirshipBundle	Airship-Bundle
PolusBundle	Polus-Bundle
PolusSkinBundle	Skin-Bundle Polus-Karte
MiraBundle	MIRA-HQ-Bundle
MiraSkinBundle	Skin-Bundle MIRA HQ
PetAlien2	Bettkrebs-Bundle
PetAlien1	Hirnschnecke-Bundle
PetAnimal	Hamster-Bundle
PetCrewmate	Mini-Besatzung-Bundle
PetStickmin	Stickmin-Bundle
PrisonerSkin	Gefangener
Cyborg_RHM	Erneuerter Handlanger
CCC_Officer	Chef der Contra-Chaos-Centrale
BeginLabel	STARTEN
QuietLabel	PSSSST!
VentCleaning	Schacht putzen
CleanUp	Saubermachen
ProgressLabel	Fortschritt:
TermsOfUseTitle	Nutzungsbedingungen
PPAndToUTitle	Datenschutzrichtlinie und Nutzungsbedingungen
	
ErrorNotAuthenticated	Die Server von Among Us konnten dich nicht identifizieren.\r\n\nDu brauchst ein Konto bei Among Us, um online zu spielen. (Gastkonto ist okay!)
ComePlayDiscord	Spiel mit mir Among Us! 
ShowAccountSupportID5	Konto-Support-ID anzeigen
ShowAccountSupportID4	Zum Anzeigen noch 4-mal drücken
ShowAccountSupportID3	Diese ID nicht weitergeben
ShowAccountSupportID2	Während des Streams nicht klicken
ShowAccountSupportID1	Diese ID unbedingt anzeigen
SupportIDLabel	Support-ID: {0}
YouAreNotOnline	Du bist nicht online.
NoDeadBodiesFound	Keine Leichen gefunden
SupportEmail	Bitte wende dich mit Support-Anfragen an support@innersloth.com.
PerfectLabel	PERFEKT